TILEMAP
160 16 							-- Size of tile map in tiles
16 16 							-- Tile size & block size
images/Water+.png 	-- Tilesheet
12 14 								-- Number of tiles in tilesheet
72,72,72,72,72,72,72,72,72,72,72,72,72,72,72,72,72,72,72,72,72,72,72,72,72,72,72,72,72,72,72,72,72,72,72,72,72,72,72,72,72,72,72,72,72,72,72,72,72,72,72,72,72,72,72,72,72,72,72,72,72,72,72,72,72,72,72,72,72,72,72,72,72,75,76,77,76,76,77,76,76,76,76,76,78,72,72,72,72,72,72,72,72,72,72,72,72,72,72,72,72,72,72,72,72,72,72,72,72,72,72,72,72,72,72,72,72,72,72,72,72,72,72,72,72,72,72,72,72,72,72,72,72,72,72,72,72,72,72,72,72,72,72,72,72,72,72,72,72,72,72,72,72,72,72,72,72,72,72,72
72,72,72,72,72,72,72,72,72,72,72,72,72,72,75,76,77,76,76,77,76,76,76,76,76,77,76,76,77,78,72,72,72,72,72,72,72,72,72,72,72,72,72,72,72,72,72,72,72,72,72,72,72,72,72,72,75,76,77,76,76,77,76,77,76,76,76,76,78,72,72,72,72,87,24,24,24,24,24,24,24,24,24,24,90,72,72,72,72,72,72,72,72,72,72,72,72,72,72,72,72,72,72,72,72,72,72,72,72,72,72,72,72,72,72,72,72,72,72,72,72,75,76,77,76,76,77,76,76,76,76,76,77,76,76,77,78,72,72,72,72,72,72,72,72,72,72,72,72,72,75,76,77,76,76,77,76,76,76,76
76,76,77,76,77,76,76,76,76,78,72,72,72,72,87,24,24,24,24,24,24,24,24,24,24,24,24,24,24,102,76,76,76,77,76,77,78,72,72,72,72,72,75,76,77,76,76,77,76,77,77,78,72,72,72,72,87,24,24,24,24,24,24,24,24,24,24,24,102,77,77,77,76,99,24,24,24,24,24,24,24,24,24,92,90,72,72,72,72,72,72,72,72,72,72,72,72,72,72,72,72,72,72,72,72,72,72,75,76,77,76,77,76,76,76,76,78,72,72,72,72,87,24,24,24,24,24,24,24,24,24,24,24,24,24,24,102,76,77,76,77,76,76,76,76,78,72,72,72,72,87,24,24,24,24,24,24,24,24,24
24,24,24,24,24,24,24,24,24,102,77,77,77,76,99,24,24,24,24,24,24,24,24,24,92,24,24,24,24,24,24,24,24,24,24,24,90,72,72,75,76,77,99,24,24,24,24,24,24,24,24,102,77,77,77,76,99,24,24,24,24,24,24,91,24,24,24,24,24,24,24,24,91,24,24,24,24,24,93,24,24,24,24,24,102,78,72,72,72,72,72,72,72,72,72,72,72,72,72,72,72,72,72,72,72,72,72,87,24,24,24,24,24,24,24,24,102,77,77,77,76,99,24,24,24,24,24,24,24,24,24,92,24,24,24,24,24,24,24,24,24,24,24,24,24,102,77,77,77,76,99,24,24,24,24,24,24,24,24,24
24,24,24,24,91,24,24,24,24,24,24,24,24,91,24,24,24,24,24,24,24,24,24,24,24,24,24,24,24,91,24,24,24,24,24,24,90,72,72,87,24,24,24,24,24,24,91,24,24,24,24,24,24,24,24,91,24,24,24,24,24,24,24,24,24,24,24,24,24,24,24,24,24,24,24,24,24,24,24,24,24,24,24,24,24,90,72,72,72,72,72,72,72,72,72,72,72,72,72,72,72,72,72,72,72,72,75,99,24,24,24,91,24,24,24,24,24,24,24,24,91,24,24,24,24,24,24,24,24,24,24,24,24,24,24,24,24,24,24,24,91,24,24,24,24,24,24,24,24,91,24,24,24,24,24,24,24,24,24,24
24,24,24,24,24,24,24,24,24,24,24,24,24,24,24,24,24,24,24,24,92,24,24,24,24,24,93,24,24,24,24,24,24,24,24,24,102,76,77,99,24,24,24,24,24,24,24,24,24,24,24,24,24,24,24,24,24,24,24,24,24,24,24,24,24,24,24,24,24,24,24,24,24,24,24,24,24,24,24,24,24,24,24,24,24,102,76,77,76,77,76,77,78,72,72,72,72,72,72,72,72,72,72,72,72,72,87,24,24,24,24,24,24,24,24,24,24,24,24,24,24,24,24,24,24,24,24,92,24,24,24,24,24,24,24,24,24,24,24,24,24,24,24,24,24,24,24,24,24,24,24,24,24,24,24,93,24,24,24,24
24,24,24,24,24,93,24,24,24,24,24,24,24,24,24,93,24,24,24,24,24,24,24,24,24,24,24,24,24,24,24,24,24,24,24,24,24,24,24,24,24,24,24,24,24,24,24,24,24,24,24,24,24,24,24,24,24,24,24,24,24,24,24,24,24,24,24,24,24,24,24,24,24,24,24,24,24,24,24,24,24,24,24,24,24,24,24,24,24,24,24,94,102,76,77,78,72,72,72,72,72,72,72,72,72,75,99,24,24,24,24,24,24,24,24,24,24,24,24,24,24,24,24,24,24,24,24,24,24,24,24,24,24,24,24,24,24,24,24,24,24,24,24,24,24,24,24,24,24,24,24,24,24,24,24,24,24,24,24,24
24,24,24,24,24,24,24,24,24,24,24,24,24,24,24,24,24,24,24,24,24,24,24,24,24,24,24,24,24,24,24,24,24,93,24,24,24,24,24,24,24,24,24,24,24,24,24,24,24,24,24,24,24,93,24,24,24,24,24,24,24,24,24,92,24,24,24,24,24,24,24,24,24,24,24,92,24,24,24,24,93,24,24,24,24,24,24,24,24,24,24,92,24,24,24,102,76,76,77,76,76,77,76,76,77,99,24,24,24,92,24,24,24,24,24,24,24,24,24,24,24,91,24,24,24,93,24,24,24,24,24,24,24,24,24,24,24,24,24,24,93,24,24,24,24,24,24,24,24,24,24,24,24,24,24,24,24,24,92,24
24,24,24,24,24,24,24,24,24,24,92,24,24,24,24,24,24,24,24,24,24,24,24,24,24,24,24,24,92,24,24,24,24,24,24,24,24,24,24,24,24,24,24,24,24,24,24,24,24,24,24,24,24,24,24,24,24,24,24,24,24,24,24,24,24,24,24,24,24,24,24,24,24,24,24,24,24,24,24,24,24,24,24,24,24,24,24,24,24,24,24,24,24,24,24,24,24,24,24,24,24,24,24,24,24,24,24,24,24,24,24,24,24,24,24,24,24,24,24,24,24,24,24,24,24,24,24,24,24,24,24,24,24,92,24,24,24,24,24,24,24,24,24,24,24,92,24,24,24,24,24,24,91,24,24,24,24,24,24,24
24,24,24,24,24,24,24,24,24,24,24,24,24,92,24,24,24,24,24,24,24,24,24,91,24,24,24,24,24,24,24,24,24,24,24,24,24,24,24,24,24,24,24,24,24,91,24,24,24,24,24,24,24,24,24,24,24,24,24,24,24,24,24,24,24,24,24,24,24,24,24,24,24,24,24,24,24,24,24,24,24,24,24,24,24,24,24,24,24,24,24,24,24,24,24,24,24,24,24,24,24,24,24,24,24,24,24,24,24,24,24,24,93,24,24,24,24,24,24,24,24,24,24,24,24,24,24,24,24,24,24,24,24,24,24,24,24,24,24,24,24,24,24,24,24,24,24,24,24,24,24,24,24,24,24,24,24,24,24,24
24,24,24,24,24,24,93,24,24,24,24,24,24,24,24,24,24,24,24,24,24,24,24,24,24,24,24,24,24,24,91,24,24,24,24,24,24,24,24,24,24,92,24,24,24,24,24,24,24,24,24,24,24,24,24,24,24,24,24,24,24,24,24,24,24,24,24,24,24,24,24,24,24,24,24,24,24,24,24,24,24,24,24,24,24,24,24,24,24,24,24,24,24,24,24,24,24,24,24,24,24,24,92,24,24,24,24,24,24,24,24,24,24,24,24,24,24,24,24,24,24,24,24,24,24,24,24,24,24,24,24,24,24,24,24,24,24,24,24,24,24,24,24,24,24,24,24,24,24,24,24,24,24,24,24,24,24,24,24,24
24,24,24,24,24,24,24,24,24,24,24,24,24,24,24,24,24,24,91,24,24,24,24,24,24,24,24,24,24,24,24,24,24,24,24,24,24,24,24,24,24,24,24,24,24,24,24,24,24,24,24,24,24,24,91,24,24,24,24,24,24,24,24,24,24,24,24,92,24,24,24,24,24,24,24,24,24,24,24,24,24,24,24,24,24,24,24,92,24,24,24,24,24,24,24,24,24,24,24,24,24,24,24,24,24,24,24,24,24,24,24,24,24,24,24,24,24,24,24,24,24,24,24,24,24,24,24,24,24,24,24,24,24,24,24,93,24,24,24,24,24,24,24,24,24,24,24,24,24,24,24,24,24,24,24,93,24,24,24,24
24,92,24,24,24,24,24,24,24,24,24,24,24,92,24,24,24,24,24,24,24,92,24,24,24,24,24,24,24,24,24,24,24,24,24,24,24,24,24,93,24,24,24,24,24,24,24,24,24,24,24,24,24,24,24,24,24,24,24,24,24,24,24,24,24,24,24,24,24,24,24,93,24,24,24,24,24,24,24,24,24,24,24,24,24,24,24,24,24,24,24,24,24,24,92,24,24,24,24,24,24,24,24,24,24,24,24,24,24,91,24,24,24,24,24,24,24,24,24,92,24,24,24,24,24,24,24,91,24,24,24,24,24,24,24,24,24,24,24,24,92,24,24,24,24,24,24,24,92,24,24,24,24,24,24,24,24,24,24,24
103,104,105,103,103,103,103,103,103,103,103,105,103,103,103,103,103,103,103,103,103,103,103,104,103,103,103,103,103,104,103,103,103,103,103,103,103,103,104,105,103,103,105,103,103,103,104,105,103,103,103,103,103,103,103,103,105,103,103,103,103,103,103,103,104,105,103,104,105,104,105,103,104,105,103,103,105,103,103,103,104,105,103,103,103,103,103,103,103,103,105,103,103,103,103,103,103,104,105,103,103,105,103,103,103,104,105,103,103,103,103,103,103,103,103,105,103,103,103,103,103,103,104,105,103,103,105,103,103,103,104,103,104,105,103,103,105,103,103,103,104,105,103,103,103,103,103,103,103,103,105,103,103,103,103,104,105,103,103,105
167,167,167,167,167,167,167,167,167,167,167,167,167,167,167,167,167,167,167,167,167,167,167,167,167,167,167,167,167,167,167,167,167,167,167,167,167,167,167,167,167,167,167,167,167,167,167,167,167,167,167,167,167,167,167,167,167,167,167,167,167,167,167,167,167,167,167,167,167,167,167,167,167,167,167,167,167,167,167,167,167,167,167,167,167,167,167,167,167,167,167,167,167,167,167,167,167,167,167,167,167,167,167,167,167,167,167,167,167,167,167,167,167,167,167,167,167,167,167,167,167,167,167,167,167,167,167,167,167,167,167,167,167,167,167,167,167,167,167,167,167,167,167,167,167,167,167,167,167,167,167,167,167,167,167,167,167,167,167,167
167,167,167,167,167,167,167,167,167,167,167,167,167,167,167,167,167,167,167,167,167,167,167,167,167,167,167,167,167,167,167,167,167,167,167,167,167,167,167,167,167,167,167,167,167,167,167,167,167,167,167,167,167,167,167,167,167,167,167,167,167,167,167,167,167,167,167,167,167,167,167,167,167,167,167,167,167,167,167,167,167,167,167,167,167,167,167,167,167,167,167,167,167,167,167,167,167,167,167,167,167,167,167,167,167,167,167,167,167,167,167,167,167,167,167,167,167,167,167,167,167,167,167,167,167,167,167,167,167,167,167,167,167,167,167,167,167,167,167,167,167,167,167,167,167,167,167,167,167,167,167,167,167,167,167,167,167,167,167,167